3 3 3 3 3 3 3 3 3 3 3 3 3 3 3 3 3 3 3 3 3 3 3 3 3 3 3 3 3 3
3 2 1 1 1 1 1 1 1 1 1 1 1 1 3 3 1 1 1 1 1 1 1 1 1 1 1 1 2 3
3 1 3 3 3 3 3 1 3 3 3 3 3 1 3 3 1 3 3 3 3 3 1 3 3 3 3 3 1 3
3 1 3 0 0 0 3 1 3 0 0 0 3 1 3 3 1 3 0 0 0 3 1 3 0 0 0 3 1 3
3 1 3 0 0 0 3 1 3 0 0 0 3 1 3 3 1 3 0 0 0 3 1 3 0 0 0 3 1 3
3 1 3 3 3 3 3 1 3 3 3 3 3 1 3 3 1 3 3 3 3 3 1 3 3 3 3 3 1 3
3 1 1 1 1 1 1 1 1 1 1 1 1 1 1 1 1 1 1 1 1 1 1 1 1 1 1 1 1 3
3 1 3 3 3 3 3 1 3 1 3 3 3 3 3 3 3 3 3 3 1 3 1 3 3 3 3 3 1 3
3 1 3 3 3 3 3 1 3 1 3 3 3 3 3 3 3 3 3 3 1 3 1 3 3 3 3 3 1 3
3 1 1 1 1 1 1 1 3 1 1 1 1 1 3 3 1 1 1 1 1 3 1 1 1 1 1 1 1 3
3 3 3 3 3 3 3 1 3 3 3 3 3 1 3 3 1 3 3 3 3 3 1 3 3 3 3 3 3 3
0 0 0 0 0 0 3 1 3 1 1 1 3 1 3 3 1 3 1 1 1 3 1 3 0 0 0 0 0 0
0 0 0 0 0 0 3 1 3 1 3 1 1 1 1 1 1 1 1 3 1 3 1 3 0 0 0 0 0 0
0 0 0 0 0 0 3 1 3 1 3 1 3 3 4 4 3 3 1 3 1 3 1 3 0 0 0 0 0 0
0 0 0 3 3 3 3 1 3 1 3 1 3 0 5 0 0 3 1 3 1 3 1 3 3 3 3 0 0 0
0 0 0 0 7 0 0 1 1 1 3 1 3 3 3 3 3 3 1 3 1 1 1 0 0 7 0 0 0 0
0 0 0 3 3 3 3 1 3 1 3 1 1 1 6 1 1 1 1 3 1 3 1 3 3 3 3 0 0 0
0 0 0 0 0 0 3 1 3 1 3 1 3 3 3 3 3 3 1 3 1 3 1 3 0 0 0 0 0 0
0 0 0 0 0 0 3 1 3 1 1 1 1 1 1 1 1 1 1 1 1 3 1 3 0 0 0 0 0 0
0 0 0 0 0 0 3 1 3 1 3 3 3 3 3 3 3 3 3 3 1 3 1 3 0 0 0 0 0 0
3 3 3 3 3 3 3 1 3 1 3 3 3 3 3 3 3 3 3 3 1 3 1 3 3 3 3 3 3 3
3 1 1 1 1 1 1 1 1 1 1 1 1 1 3 3 1 1 1 1 1 1 1 1 1 1 1 1 1 3
3 1 3 3 3 3 3 1 3 3 3 3 3 1 3 3 1 3 3 3 3 3 1 3 3 3 3 3 1 3
3 2 1 1 1 3 3 1 1 1 1 1 1 1 1 1 1 1 1 1 1 1 1 3 3 1 1 1 2 3
3 3 3 3 1 3 3 1 3 1 3 3 3 3 3 3 3 3 3 3 1 3 1 3 3 1 3 3 3 3
3 3 3 3 1 3 3 1 3 1 3 3 3 3 3 3 3 3 3 3 1 3 1 3 3 1 3 3 3 3
3 1 1 1 1 1 1 1 3 1 1 1 1 1 3 3 1 1 1 1 1 3 1 1 1 1 1 1 1 3
3 1 3 3 3 3 3 3 3 3 3 3 3 1 3 3 1 3 3 3 3 3 3 3 3 3 3 3 1 3
3 1 1 1 1 1 1 1 1 1 1 1 1 1 1 1 1 1 1 1 1 1 1 1 1 1 1 1 1 3
3 3 3 3 3 3 3 3 3 3 3 3 3 3 3 3 3 3 3 3 3 3 3 3 3 3 3 3 3 3
